x,x,x,x,x,x,x,x,x,x,x,x,x,x,x,x,x,x,x,x,x,x,x,x,x,x,x,x,x,x,x,x,x,x,x,x,x,x,x,x,x,x,x,x,x,x,x,x,x,x,x,x,x,x,x,x,x,x,x,x,x,x,x,x,x,x,x,x,x,x,x,x,x,x,x,x,x,x,x,x,x,x,x,x,x,x,x,x,x,x,x,x,x,x,x,x,x,x,x,x
x,,,,,,,,,,,,,,,,,,,,,f,f,f,f,f,f,f,f,f,f,f,f,f,f,f,f,f,f,f,f,f,,,,,,,,,,,,,,,,,,,,,,,,,,,,,,,,,,,,,,,,,,,,,,,,,,,,,,,,,,x
x,,,,,,,,,,,,,,,,,,,,,,f,f,f,f,f,f,f,f,f,f,f,f,f,f,f,f,f,f,f,,,,,,,,,,,,,,,,,,,,,,,,,,,,,,,,,,,,,,,,,,,,,,,,,,,,,,,,,,,x
x,,,,,,,,,,,,,,,,,,,,,,f,f,f,f,f,f,f,f,f,f,f,f,f,f,f,f,f,f,,,,,,,,,,,,,,,,,,,,,,,,,,,,,,,,,,,,,,,,,,,,,,,,,,,,,,,,,,,,x
x,,,,,,,,,,,,,,,,,,,,,,,f,f,f,f,f,f,f,f,f,f,f,f,f,f,f,f,,,,,,,,,,,,,,,,,,,,,,,,,,,,,,,,,,,,,,,,,,,,,,,,,,,,,,,,,,,,,x
x,,,,,,,,,,,,,,,,,,,,,,,,f,f,f,f,f,f,f,f,f,f,f,f,f,f,,,,,,,,,,,,,,,,,,,,,,,,,,,,,,,,,,,,,,,,,,,,,,,,,,,,,,,,,,,,,,x
x,,,,,,,,,,,,,,,,,,,,,,,,f,f,f,f,f,f,f,f,f,f,f,f,f,f,,,,,,,,,,,,,,,,,,,,,,,,,,,,w,w,w,w,,,,,,,,,,,,,,,,,,,,,,,,,,,,,,,x
x,,,,,,,,,,,,,,,,,,,,,,,,,,f,f,f,f,f,f,f,f,f,f,,,,,,,,,,,,,,,,,,,,,,,,,,,,,,w,w,w,w,,,,,,,,,,,,,,,,,,,,,,,,,,,,,,,x
x,,,,,,,,,,,,,,,,,,,,,,,,,,,,,,,,f,f,f,,,,,,,,,,,,,,,,,,,,,,,,,,,,,,,w,w,w,w,w,w,w,,,,,,,,,,,,,,,,,,,,,,,,,,,,x
x,,,,,,,,,,,,,,f,f,,,,,,,,,,,,,,,,f,f,f,,,,,,,,,,,,,,,,,,,,,,,,,,,,,,,,w,w,w,w,w,w,w,,,,,,,,,,,,,,,,,,,,,,,,,,,,x
x,,,,,,,,,,,,,,,f,f,,,,,,,,,,,,,,f,f,f,,,,,,,,,,,,,,,,,,,,,,,,,,,,,,,,w,w,w,w,w,w,w,w,,,,,,,,,,,,,,,,,,,,,,,,,,,,x
x,,,,,,,,,,,,,,,,f,f,,,,,,,,,,,,f,f,f,,,,,,,,,,,,,,,,,,,,,,,,,,,,,,,,,,w,w,w,w,w,w,w,,,,,,,,,,,,,,,,,,,,,,,,,,,,x
x,,,,,,,,,,,,,,,,,f,f,,,,,,,,,,f,f,f,,,,,,,,,,,,,,,,,,,,,,,,,,,,,,,,,,,w,w,w,w,w,,,,,,,,,,,,,,,,,,,,,,,,,,,,,,x
x,,,,,,,,,,,,,,,,,,f,f,f,,,,,,,f,f,f,,,,,,,,,,,,,,,,,,,,,,,,,,,,,,,,,,,w,w,w,w,w,,,,,,,,,,,,,,,,,,,,,,,,,,,,,,,x
x,,,,,,,,,,,,,,,,,,,f,f,f,f,,,,f,f,f,,,,,,,,,,,,,,,,,,,,,,,,,,,,,,,,,,,,,w,w,w,w,w,,,,,,,,,,,,,,,,,,,,,,,,,,,,,,x
x,,,,,,,,,,,,,,,,,,,,,f,f,f,f,f,f,f,,,,,,,,,,,,,,,,,,,,,,,,,,,,,,,,,,,,,,w,w,w,w,w,w,,,,,,,,,,,,,,,,,,,,,,,,,,,,,x
x,,,,,,,,,,,,,,,,,,,,,,,f,f,f,f,,,,,,,,,,,,,,,,,,,,,,,,,,,,,,,,,,,,,,,,w,w,w,w,w,,,,,,,,,,,,,,,,,,,,,,,,,,,,,x
x,,,,,,,,,,,,,,,,,,,,,,,f,f,,,,,,,,,,,,,,,,,,,,,,,,,,,,,,,,,,,,,,,,,,,w,w,w,w,w,w,,,,,,,,,,,,,,,,,,,,,,,,,,,x
x,,,,,,,,,,,,,,,,,,,,,,f,f,,,,,,,,,,,,,,,,,,,,,,,,,,,,,,,,,,,,,,,,,,,,,w,w,w,w,w,w,,,,,,,,,,,,,,,,,,,,,,,,,,x
x,,,,,,,,,,,,,,,,,,,,,f,f,,,,,,,,,,,,,,,,,,,,,,,,,,,,,,,,,,,,,,,,,,,,,,,w,w,w,w,w,w,,,,,,,,,,,,,,,,,,,,,,,,,x
x,,,,,,,,,,,,,,,,,,,f,f,f,,,,,,,,,,,,,,,,,,,,,,,,,,,,,,,,,,,,,,,,,,,,,,,,,w,w,w,w,w,w,,,,,,,,,,,,,,,,,,,,,,,,x
x,,,,,,,,,,,,,,,,,,,,,,,,,,,,,,,,,,,,,,,,,,,,,,,,,,,,,,,,,,,,,,,,,,,,,,,w,w,w,w,w,w,,,,,,,,,,,,,,,,,,,,,,,x
x,,,,,,,,,,,,,,,,,,,,,,,,,,,,,,,,,,,,,,,,,,,,,,,,,,,,,,,,,,,,,,,,,,,,,,,,w,w,w,w,w,w,w,w,w,w,w,w,w,w,w,w,w,w,w,w,,,,,,,,x
x,,,,,,,,,,,,,,,,,,,,,,,,,,,,,,,,,,,,,,,,,,,,,,,,,,,,,,,,,,,,,,,,,,,,,,,,,w,w,w,w,w,w,w,w,w,w,w,w,w,w,w,w,w,w,w,w,,,,,,,x
x,,,,,,,,,,,,,,,,,,,,,,,,,,,,,,,,,,,,,,,,,,,,,,,,,,,,,,,,,,,,,,,,,,,,,,,,,,w,w,w,w,w,w,w,w,w,w,w,w,w,w,w,w,w,w,w,w,,,,,,x
x,,,,,,,,,,,,,,,,,,,,b,b,b,b,b,b,b,b,b,b,,,,,,,,,,,,,,,,,,,,,,,,,,,,,,,,,,,,,,,,,,,,,,w,w,w,w,w,w,w,w,w,w,w,w,w,w,w,w,w,w,w,w,,,,,x
x,,,,,,,,,,,,,,,,,,,,b,b,b,b,b,b,b,b,b,b,,,,,,,,,,,,,,,,,,,,,,,,,,,,,,,,,,,,,,,,,,,,,,,w,w,w,w,w,w,w,w,w,w,w,w,w,w,w,w,w,w,w,w,,,,x
x,,,,,,,,,,,,,,,,,,,,b,b,,,,,,,b,b,,,,,,,,,,,,,,,,,,,,,,,,,,,,,,,,,,,,,,,,,,,,,,,,,,,,,,,,,,,,,,w,w,w,w,w,w,,,x
x,,,,,,,,,,,,,,,,,,,,b,b,,,,,,,b,b,,,,,,,,,,,,,,,,,,,,,,,,,,,,,,,,,,,,,,,,,,,,,,,,,,,,,,,,,,,,,,,w,w,w,w,w,w,,x
x,,,,,,,,,,,,,,,,,,,,,,,,,,,,b,b,,,,,,,,,,,,,,,,,,,,,,,,,,,,,,,,,,,,,,,,,,,,,,,,,,,,,,,,,,,,,,,,w,w,w,w,w,w,x
x,,,,,,,,,,,,,,,,,,,,b,b,,,,,,,b,b,,,,,,,,,,,,,,,,,,,,,,,,,,,,,,,,,,,,,,,,,,,,,,,,,,,,,,,,,,,,,,,,,w,w,w,w,w,x
x,,,,,,,,,,,,,,,,,,,,b,b,b,b,b,b,b,b,b,b,,,,,,,,,,,,,,,,,,,,,,,,,,,,,,,,,,,,,,,,,,,,,,,,,,,,,,,,,,,,,,,,,,w,w,w,w,x
x,,,,,,,,,,,,,,,,,,,,b,b,b,b,b,b,b,b,b,b,,,,,,,,,,,,,,,,,,,,,,,,,,,,,,,,,,,,,,,,,,,,,,,,,,,,,,,,,,,,,,,,,,,w,w,w,x
x,,,,,,,,,,,,,,,,,,,,,,,,,,,,,,,,,,,,,,,,,,,,,,,,,,,,,,,,,,,,,,,,,,,,,,,,,,,,,,,,,,,,,,,,,,,,,,,,,,w,x
x,x,x,x,x,x,x,x,x,x,x,x,x,x,x,x,x,x,x,x,x,x,x,x,x,x,x,x,x,x,x,x,x,x,x,x,x,x,x,x,x,x,x,x,x,x,x,x,x,x,x,x,x,x,x,x,x,x,x,x,x,x,x,x,x,x,x,x,x,x,x,x,x,x,x,x,x,x,x,x,x,x,x,x,x,x,x,x,x,x,x,x,x,x,x,x,x,x,x,x
